XXXXXXXXXXXXXXXXXXXXXXXXXXXXXXXXXXXXXXXXXXXXXXXXXXXXXXXXXXXXXXXXXXXXXXXXXXXXXXXXXXXXXXXXXXXXXXXXXXXXX
P             X     X     X X   X       X X     X X       X       X   X                 X           X
XXXXXXXXX X X X XXX X XXX X X X X XXX X X X X X X X XXXXX X XXX XXX X X XXXXXXXXXXX XXX XXX XXXXXXXXX
X       X X X   X     X X X   X   X   X X   X X   X   X X X X X     X X     X     X X X   X         X
X XXXXX XXX XXXXXXXXXXX X XXXXXXX X XXX XXXXX XXX XXX X X X X XXXXXXX XXXXX X X XXX X XXX XXXXX XXX X
X X   X     X         X         X X X X       X X X   X X   X   X   X X       X X   X   X     X X   X
X X X XXXXXXX XXXXXXX X XXXXXXX XXX X XXXXXXXXX X X XXX XXXXX XXX X X X XXXXXXXXX XXX XXXXXXX XXX X X
X X X X         X   X X X   X X     X             X X   X     X   X X       X     X   X       X   X X
X X X X XXXXXXX X XXX XXX X X XXXXX XXXXXXXXX XXXXX X X XXX XXX XXX X XXXXXXX XXXXX XXX XXXXXXX XXX X
X   X   X   X     X   X   X X   X   X       X X   X   X   X X   X X X   X     X           X     X X X
X XXXXXXX X XXXXX X X X XXX X XXX XXX XXXXX X X X XXXXXXX X X XXX X XXX X XXXXX XXXXXXXXX XXX XXX X X
X   X X   X     X X X X   X X   X X X X   X X   X     X     X X   X   X X X       X     X   X X X   X
XXX X X XXXXXXX XXX XXXXX X XXX X X X XXX X XXXXXXXXXXX XXXXX X XXXXX XXX X XXXXXXX XXX XXX X X X XXX
X   X X       X   X X     X   X X   X X   X   X   X     X     X X   X   X X X   X     X X X   X X   X
X XXX XXXXXXX XXX X X XXXXXXX X XXX X X X XXX X X X XXXXX XXXXX X X XXX X XXX X X XXXXX X XXXXX XXX X
X X         X   X   X   X   X X     X   X   X   X X X X   X   X   X       X   X   X X   X     X     X
X X XXX XXXXXXX XXXXXXX XXX X XXXXX XXXXXXX XXXXX X X X XXX X XXXXXXXXXXX X XXXXXXX X XXX XXXXX XXXXX
X X   X X     X             X     X X         X   X X X   X X   X       X X X       X   X           X
X XXX XXX XXX X XXXXXXXXXXXXX XXX XXX XXXXXXXXX X X X XXX X XXX X XXXXX XXX X XXXXXXXXX X XXXXXXXXX X
X     X   X   X X           X   X         X   X X X   X X   X X X X   X   X X X   X     X X     X   X
XXXXXXX XXX XXXXX XXXXXXXXX XXX XXXXXXXXX X X X X XXX X XXXXX X X X XXXXX X X X X X XXXXX X XXX X XXX
X     X   X       X         X     X   X X X X   X   X X       X X X     X   X X X   X     X   X X   X
X XXX X X XXX XXXXXXX XXXXXXXXXXXXX X X X X XXXXXXXXX XXX X X X X X XXX XXXXX X XXXXXXXXXXXXX X XXX X
X X   X X X X X     X             X X X   X         X   X X X X   X X       X X             X X X   X
X X XXXXX X X X XXX XXXXXXXXXXXXX X X XXXXX XXXXXXX XXX X X XXXXXXX X XXXXX X XXXXXXXXXXXXX X X XXX X
X X       X   X   X       X       X X     X   X X     X X X       X X   X   X       X     X   X   X X
X XXXXXXXXXXXXXXX XXXXXXX XXXXXXX X XXXXX XXX X X XXXXX XXXXX X XXX XXX X XXX XXXXXXX X XXXXXXXXX X X
X       X           X   X       X   X   X   X   X       X   X X     X   X   X X     X X X       X X X
X XXXXX X XXXXXXXXXXX X XXXXXXX XXXXX XXXXX XXX XXXXXXXXX X XXXXXXX X XXXXX X X XXX X X X XXXXX X X X
X X   X   X       X   X         X   X         X           X X     X X     X X     X   X X X   X   X X
X XXX XXXXX XXXXX X XXXXXXXXXXXXX X X XXXXXXX XXXXXXXXXXXXX X XXX XXXXXXX X XXXXXXXXXXX X X X X XXXXX
X   X   X   X   X X           X   X     X   X     X     X     X           X       X   X X   X X X   X
XXX X XXX XXX XXX XXXXXXXXXXX X XXXXXXXXX X XXXXX X XXX X XXXXXXXXXXXXX XXXXXXXXX X X X XXXXX XXX X X
X   X   X X     X X         X X   X       X   X     X   X X X     X     X   X   X X X   X   X     X X
X XXX X X XXXXX X X X XXXXXXX X XXX XXXXXXXXX X XXXXXXX X X X XXX XXXXXXX X X X X X XXX XXX XXXXXXX X
X X   X     X   X   X   X     X X   X     X   X X     X X   X X X         X X X     X             X X
X XXX XXXXX X XXXXXXXXX X XXXXXXX XXX XXX X XXX X XXX X XXXXX X XXXXXXXXXXX XXXXXXXXX XXXXXXXXX XXX X
X   X X   X   X   X     X     X   X   X   X   X X   X X       X         X   X   X       X   X   X   X
XXX X X X XXX X X X XXXXXXXXX X XXX XXX X XXX X XXX X XXXXXXX XXXXXXXXX X XXX X XXXXXXXXX X XXX X X X
X   X X X   X X X X       X   X X     X X X   X X X X     X   X     X   X     X X     X   X   X X X X
X XXX X XXX XXX X XXXXX X X XXX XXXXXXX XXX XXX X X XXXXX XXX X XXX X XXXXXXXXX X XXX X XXXXX XXX XXX
X   X X   X X   X       X X X   X       X   X X   X X   X   X X X   X     X   X X X     X   X   X   X
XXX XXXXX X X XXXXXXXXXXXXX X XXX XXXXX X XXX XXX X X XXXXX XXX X XXXXXXX X X X X X XXXXX X XXX X X X
X X X     X   X   X       X X   X X     X X     X X X     X   X X       X X X     X X     X   X X X X
X X X XXXXXXX X X X XXXXX X XXX X XXX XXX X X XXX X XXX X XXX X XXXXXXX X X XXXXX XXX XXXXXXX X XXX X
X X   X   X   X X   X   X X   X X   X X X X X X   X   X X X   X     X X X   X   X X   X     X X X   X
X XXXXX XXX XXX XXXXX XXX X X X X X X X X X XXX XXXXX XXX X X XXXXX X X XXXXX X X X XXX XXX X X X XXX
X         X   X X   X   X   X X X X X   X X         X X   X X     X X X X     X X X   X X   X X X   X
X XXXXXXX X XXX X X X X XXXXX X X X XXXXX XXX XXXXXXX X X X X XXXXX X X X XXXXX XXXXX X X XXX X XXX X
X   X     X X   X X X X   X   X X X     X   X   X       X X X X   X   X X X   X       X X     X     X
X XXX XXX X X XXX X XXXXX X XXX X XXXXX XXX XXX X XXXXXXXXX XXX X XXX X X X X XXXXXXXXX XXXXXXXXXXXXX
X X   X   X X     X X     X X X X   X   X X   X X   X X     X   X X   X   X X X     X   X       X   X
XXX XXX XXX XXXXXXX X XXXXX X X XXXXX X X XXX XXXXX X X XXXXX XXX X XXXXXXX X X X XXX XXX XXXXX X X X
X   X   X X X   X X X         X       X   X X         X         X X       X X   X   X     X   X   X X
X XXX XXX X X X X X XXXXXXXXX XXXXXXXXXXX X XXXXXXXXXXXXXXXXXXXXX XXXXXXX XXXXXXXXX XXXXXXX X X XXX X
X X   X   X X X X X X       X X     X   X   X     X     X   X     X       X   X     X     X X X X   X
X X XXX XXX X X X X X XXXXX X X XXX X XXXXX X XXX X XXX X X X XXXXX XXXXXXX X X XXX X XXX X X XXX X X
X X   X   X   X   X   X X   X   X X   X     X   X X   X   X X     X X       X   X   X X X   X   X X X
X XXX XXX XXXXXXX XXXXX X XXXXXXX XXX X XXXXX XXX XXX XXXXX XXXXX X X XXXXXXX XXXXXXX X XXXXXXX X XXX
X X     X     X   X     X       X     X X     X   X   X           X X X   X   X       X       X X   X
X XXXXX X X XXX XXXXXXX XXXXXXX XXXXXXX XXXXXXX XXX X XXXXXXXXXXXXX X X X X XXX XXXXXXX XXX XXX X X X
X X   X   X X   X       X     X X       X       X   X X       X   X   X X X X   X       X   X   X X X
X X X XXXXXXX XXX XXXXX XXXXX X X XXXXXXX XXXXX X XXXXX XXXXX X X XXXXX X X X XXX XXXXXXX X X XXXXX X
X X X         X   X           X X X           X X       X   X   X       X X X   X     X   X X     X X
X X XXXXXXXXXXXXX XXXXX XXXXXXX X X XXXXX XXX XXXXXXX XXX X XXXXXXXXXXX XXX XXX XXXXX X XXXXXXXXX X X
X   X X         X     X X     X   X X   X   X X     X   X X X       X   X   X   X   X X     X     X X
X XXX X XXXXX X XXXXX XXX XXX XXXXXXX X XXX X X XXX XXX X X X XXXXX X XXX XXX XXXXX X XXXXX X XXXXX X
X   X X   X X X X   X     X   X     X X   X X X   X   X X X   X   X   X   X   X     X   X   X       X
XXX X XXX X X X X X X XXXXX X X XXX X XXX XXX XXX XXX XXX XXXXX XXXXX X XXX XXX X XXXXX X X XXXXXXX X
X X X X   X X X   X X X     X   X   X X X X     X   X     X   X       X X X   X X X     X X   X     X
X X X X XXX X XXXXX XXX XXXXXXXXX XXX X X X XXX XXX XXXXXXX X XXXXX XXX X XXX X X X XXXXX XXX X XXXXX
X X X       X X   X     X       X   X X   X   X X X     X   X X   X X   X   X X X X X   X   X X     X
X X XXXXXXXXX X X XXXXXXX XXXXXXXXX X XXX XXX X X XXXXX X XXX X X XXX XXX X X X XXX XXX XXX XXXXXXX X
X X     X     X X X       X       X X   X     X X     X X X   X X X   X   X X X   X   X   X       X X
X XXXXX X XXXXX XXX XXX X X XXXXX X XXX XXXXXXX XXXXX X X X XXX X X XXX XXX X X X XXX X X XXXXX X X X
X     X   X         X   X X     X   X   X     X   X   X   X     X X X   X   X X X   X X X     X X X X
XXXXX XXXXX XXXXXXXXX XXXXXXXXX XXXXX XXXXXXX XXX X X XXXXXXXXXXX X XXX X X X XXX X X X XXXXXXX X X X
X         X X   X   X           X       X     X     X   X       X X   X X X X   X X X   X       X X X
X XXXXX XXX X XXX X XXXXXXXXXXXXXXXXXXX X XXXXX XXXXXXXXX XXX XXX XXX XXX XXXXX X XXXXX X XXXXXXXXX X
X X   X X   X     X X             X     X X       X         X   X   X X   X     X   X   X X         X
X X X X X XXXXX XXX X XXX XXXXXXX X XXXXX X XXXXXXX XXXXXXXXXXX XXX X X X X XXXXXXX X XXX X XXXXXXXXX
X X X   X     X   X   X   X       X     X   X   X   X         X   X   X X X   X     X X X   X       X
X X XXXXXXXXX X XXXXX X XXX XXXXXXXXXXX X XXX X X XXX XXXXXXX X X XXXXX X XXX X XXXXX X XXXXX XXXXX X
X X       X   X X   X X   X X   X       X   X X   X X   X     X X       X X   X X   X     X   X X   X
X XXXXX XXX XXXXX X X XXX X XXX X X XXXXX XXX XXXXX XXX XXXXX XXXXXXXXX X X XXX X X XXXXX X X X X XXX
X   X   X   X     X X X   X   X   X X     X           X X   X           X X   X X X   X   X X X X X X
X X XXXXX XXXXX XXX X X XXXXX XXX X XXXXXXX XXXXXXXXX X X X XXXXXXX XXXXXXXXX X X XXX X XXXXX X X X X
X X       X     X X X X   X     X X         X     X   X   X   X   X X     X   X X X X X       X X X X
X XXXXXXXXXXX XXX X XXX X XXXXX XXXXXXXXXXXXX XXX XXXXXXXXXXX X X XXX XXX X XXX X X X XXXXXXXXX X X X
X             X   X   X X     X           X   X X         X   X X   X   X X   X X X X           X X X
XXXXXXXXXXXXXXX XXXXX X XXXXX XXXXXXXXXXX X XXX XXXXXXXXX X XXX XXX X X X X X X X X XXXXXXX XXXXX X X
X       X X         X X X     X X       X   X X       X   X X     X X X X X X X           X     X X X
XXXXX X X X XXXXXXX X XXX XXXXX X XXXXX XXXXX X X XXXXX XXX X XXXXX XXX X X X XXXXXXXXXXX XXXXX X X X
X     X   X X   X   X     X     X X X         X X X   X X   X X     X   X X X   X X       X   X X X X
X X XXXXXXX XXX X XXXXXXXXXXXXX X X X XXXXXXXXX X X X X X X X XXXXXXX XXX X XXX X X XXXXXXX X X X X X
X X X     X     X               X   X X   X   X X   X   X X X         X   X X   X   X X   X X   X X X
X X X XXX XXXXX XXX XXXXXXXXXXXXXXX X X X X X X XXXXXXXXXXX XXXXXXXXXXX XXX X XXX XXX X X X XXXXX X X
X X X   X X   X   X       X   X   X X   X X X   X         X     X       X   X X X X   X X   X   X X X
X XXXXX X X X XXX XXXXXXX X X X X X XXXXX X XXXXXXXXXXX X XXXXX X XXXXXXXXXXX X X XXX X XXXXX X X X X
X       X   X           X   X   X       X               X       X             X       X       X     K
XXXXXXXXXXXXXXXXXXXXXXXXXXXXXXXXXXXXXXXXXXXXXXXXXXXXXXXXXXXXXXXXXXXXXXXXXXXXXXXXXXXXXXXXXXXXXXXXXXXXX
